**XXXXXXXXXXXXXXXXXX
X***********X*******
XXX*X*XXX*XXX*X*X*XX
X*X*X***X***X*X*X***
X*X*X*X*XXX*X*XXXXX*
X***X*X***X***X***X*
XXXXX*XXX*XXXXX*XXX*
X***X***X*****X***X*
X*XXXXX*X*XXX*XXX*X*
X***X***X***X***X*X*
XXX*X*XXX*X*XXX*X*X*
X***X***X*X***X*X*X*
X*XXXXX*X*XXX*X*X*X*
X*X***X*X*X***X***X*
X*X*X*X*X*X*XXXXXXX*
X*X*X***X*X*******X*
X*X*XXXXX*XXXXXXX*X*
X*X*****X*X*****X*X*
X*XXXXX*X*X*XXX*XXX*
X*******X*X***X*****